%%%%%%%
%  P  %
% % % %
%.    %
%%%%%%%