%%%%%%%
%    P%
% % % %
%.    %
%%%%%%%